411111111111111111111111111115
0CDDDDDDDDDDDDDDDDDDDDDDDDDDE2
0............................2
0............................2
0............................2
0............................2
0............................2
0............................2
0............................2
0............................2
0............................2
0............................2
0............................2
633333333333333333333333333337
