411111111111111111111111111115
0CDDDDDDDDDDDDDDDDDDDDDDDDDDE2
0............................2
0......T...........T.........2
0...839......................2
0...2F0......................2
0...A1B................839...2
0...CDE................2F0...2
0..........T...........A1B...2
0......................CDE...2
0............................2
0............................2
0............................2
633333333333333333333333333337
