411111111111115FF4111111111115
0CDDDDDDDDDDDD2FF0DDDDDDDDDDE2
0.............2FF0...........2
0.............2FF0...........2
0.............A11B...........2
0.............CDDE...........2
0............................2
0............................2
0............................2
0............................2
0............................2
0............................2
0............................2
633333333333333333333333333337
